-greetings
thank you | arigatou | ありがとう
hello | kon'nichiwa | こんにちは
nice to meet you | hajimemashite | はじめまして
good morning | ohayougozaimasu | おはようございます
good evening | konbanwa | こんばんは
goodbye | sayounara | さようなら
he | kare | かれ | 彼
she | kanojo | かのじょ | 彼女
I | watashi | わたし | 私
please (polite suffix) | kudasai | ください | 下さい
please (standalone) | onegaishimasu | おねがいします | お願いします
please (polite prefix) | douzo | どうぞ
they (men) | karera | かれら | 彼ら
they (women) | kanojotachi | かのじょたち | 彼女達
we | watashitachi | わたしたち | 私達
you (plural) | anatatachi | あなたたち | 貴方達
you (singular) | anata | あなた | 貴方

-nationality
American person | amerikajin | アメリカじん | アメリカ人
Australian person | oosutorariajin |　オーストラリアじん　| オーストラリア人
Belgian person | berugiijin |　ベルギーじん　| ベルギー人
British person | igirisujin | イギリスじん | イギリス人
Chinese language | chuugokugo | ちゅうごくご　| 中国語
Chinese person | chuugokujin | ちゅうごくじん | 中国人
Dutch person |orandajin|オランダじん|オランダ人
Dutch language|orandago|オランダご|オランダ語
English language|eigo|えいご|英語
French person|furansujin|フランスじん|フランス人
French language|furansugo|フランスご|フランス語
German person|doitsujin|ドイツじん|ドイツ人
German language|doitsugo|ドイツご|ドイツ語
Indian person|indojin|インドじん|インド人
Italian person|itariajin|イタリアじん|イタリア人
Italian language|itariago|イタリアご|イタリア語
Japanese language|nihongo|にほんご|日本語
Japanese person|nihonjin|にほんじん|日本人
Korean person|kankokujin|かんこくじん|韓国人
Korean language|kankokugo|かんこくご|韓国語
Portuguese person|porutogarujin|ポルトガルじん|ポルトガル人
Portuguese language|porutogarugo|ポルトガルご|ポルトガル語
Spanish person|supeinjin|スペインじん|スペイン人
Spanish language|supeingo|スペインご|スペイン語

-numbers 
0 (zero)|zero/rei|ゼロ|零
-kanji type format: "!eng (sub)|romaji|kanji|strokes|crosses?|joins?|contacts?"
!1 (one)|ichi|一|1|0|0
!2 (two)|ni|ニ|2|0|0
!3 (three)|san|三|3|0|0
!4 (four)|shi/yon|四|5|||3,5
!5 (five)|go|互|4|||4
!6 (six)|roku|六|4|0|0,1
!7 (seven)|shichi/nana|七|2|1|0
!8 (eight)|hachi|八|2|0|0
!9 (nine)|kyuu/ku|九|2|1|0
!10 (ten)|juu|十|2|1|0
!100 (hundred)|hyaku|百|6|||7
!1000 (thousand)|sen|千|3|1|1

-family
child|kodomo|こども|子供
cousin (female)|itoko|いとこ|従姉妹
cousin (male)|itoko|いとこ|従兄弟
family|kazoku|かぞく|家族
grandchildren|mago|まご|孫
grandfather|sofu|そふ|祖父
grandmother|sobo|そぼ|祖母
head of the family|shujin|しゅじん|主人
siblings|kyoudai|きょうだい|兄弟
son|musuko|むすこ|息子
daughter|musume|むすめ|娘
uncle|oji|おじ|伯父
aunt|oba|おば|伯母
wife|tsuma|つま|妻
younger brother|otouto|おとうと|弟
younger sister|imouto|いもうと|妹
older brother|ani|あに|兄
older sister|ane|あね|姉
name|namae|なまえ|名前

-jobs & education
employee|kaishain|かいしゃいん|会社員
part-timer|paatotaimaa|パートタイマー
college student|daigakusei|だいがくせい|大学生
high school student|koukousei|こうこうせい|高校生
middle school student|chuugokusei|ちゅうごくせい|中国製
schoolchild|shougakusei|しょうがくせい|小学生

-places
bank|ginkou|ぎんこう|銀行
beauty salon|biyouin|びよういん|美容院
bookstore|honya|ほにゃ|本屋
butcher shop|nikuya|にくや|肉屋
department store|depaato|デパアト
fish shop|sakanaya|さかなや|魚屋
high school|koukou|こうこう|高校
hospital|byouin|びょいうん|病院
junior high school|chuugakkou|ちゅうがっこう|中学校
kindergarten|youchien|ようちえん|幼稚園
library|toshokan|としょかん|図書館
nursery school|hoikuen|ほいくえん|保育園
post office|yuubinkyoku|ゆうびんきょく|郵便局
primary school|shougakkou|しょうがっこう|小学校
supermarket|suupaamaaketto|スウパアマアケット
university|daigaku|だいがく|大学
vegetable store|yaoya|やおや|八百屋

-going out
then|sorekara|それから
first of|hajime ni|はじめに|初めてに
on the way back|kaeri ni|かえりに|帰りに
I'll go and come back|ittekimasu|いってきます
have a nice day/see you later (literally "go and be back")|itterasshai|いってらっしゃい
take care/be careful|ki o tsukete|きをつけて|気をつけて
I'm back/home|tadaima|ただいま
welcome back/home|okaerinasai|おかえりなさい|お帰りなさい

-verbs
to buy (godan verb)|kau|かう|買う
to go (godan verb)|iku|いく|行く
to pass (godan verb)|yoru|よる|寄る
to sell (godan verb)|uru|うる|売る



